8 38
#.E.#######...###.....2.##########..#.
#.#.#.#.#..##.######.##..............#
#.#.#.#.#.##..#.##....##.##.#.######..
........#.##.##.#..##.##.########.1..#
####.##...........###....#..S.......##
....####.#.######..##.#.######.#######
###.####.#########.##.#.##............
.....5......##.......6.....###########
