8 38
#...#######...###.....2.##########..#.
#.#.#.#.#..##.######.##..............#
#.#.#.#.#.##..#.##....##.##E#.######..
........#.##.##.#..##.##.########.1..#
####.##..#........###....#..S.......##
....####..#######..##.#.######.#######
###.####.#########.##.#.##............
.....5......##.......6.....###########
