8 38
#...#######...###.....2.##########..#.
#.#.#.#.#..##.######.##..............#
#.#.#.#.#.##..#.##....##.####.######..
........#.##.##.#..##.##.########.1..#
####.##..#........###....#..S.......##
....####E.#######..##.#.######.#######
###.####.#########.##.#.##............
.....5......##.......6.....###########
